^^^``````````***`````````````````````^
^^````**``````*`````````~~~`````````^^
^^```**```````````````~~~~~~```````^^^
^`````````````````````~~~~~~~~~~^^^^^^
````~~~````````*```````~~~~~~~~~~~~~~~
````~~~````````***```````***```^^^
```~~~~```````**````**^^``*``````^^^^^
`````~~~```````````**^^^^`````````^^^^
*````~~~~```````*```***^^^^```**```^^^
*``````~````````***```**``````*``````^
*``````````````**```````````````````^^
**````````````````````````````````^^^^
*****````````````_````````````^^^^^^^^
**********```````````````^^^^^^^^^^^^^
**************~~~~~^^^^^^^^^^^^^^^^^^^