^^^``````````***`````````````````````^
^^````**``````*`````````~~~`````````^^
^^```**```````````````~~~~~~```````^^^
^`````````````````````~~~~~~~~~~^^^^^^
````~~~````````*```````~~~~~~~~~~~~~~~
````~~~````````***```````***```^^^^^^^
```~~~~```````**````**^^``*``````^^^^^
`````~~~```````````**^^^^`````````^^^^
*````~~~~```````*```***^^^^```**```^^^
*``````~````````***```**``````*```````
*``````````````**`````````````````````
**````````````````````````````````^^^^
*****````````````_````````````^^^^^^^^
**********```````````````^^^^^^^^^^^^^
************``~~~~~^^^^^^^^^^^^^^^^^^^